WWWWWWWWWWW   WWWWWWWWWWW
W                      WW
W                       W
W                       W
W                       W
W                  S    W
W                       W
W           W           W
           WWW           
          WWWWW          
           WWW           
W           W           W
W                       W
W                       W
W           S           W
W                       W
W                       W
WW                     WW
WWWWWWWWWWW   WWWWWWWWWWW